2 2 2 1 2 2 3 2 2 1 2 2 2
2 1 1 1 2 2 3 2 2 1 1 1 2
2 1 2 2 2 2 3 2 2 2 2 1 2
1 1 2 2 2 2 3 2 2 2 2 1 1
2 2 4 4 4 4 1 4 4 4 4 4 4
2 2 4 2 2 2 2 2 2 2 4 2 2
2 2 4 2 4 4 4 4 4 2 4 2 2
2 2 4 2 4 5 5 5 4 2 4 2 2
2 2 4 2 4 5 5 5 4 2 4 2 2
2 2 4 2 4 5 5 5 4 2 4 2 2
2 2 4 2 4 5 5 5 4 2 4 2 2
2 2 4 2 4 5 5 5 4 2 4 2 2
2 2 4 2 4 4 4 4 4 2 4 2 2
2 2 4 2 2 2 2 2 2 2 4 2 2
4 4 4 4 4 4 1 4 4 4 4 2 2
2 2 2 2 2 2 3 2 2 2 2 2 2
1 1 2 2 2 2 3 2 2 2 2 1 1
2 1 2 2 2 2 3 2 2 2 2 1 2
2 1 1 1 2 2 3 2 2 1 1 1 2
2 2 2 1 2 2 3 2 2 1 2 2 2